#########################
#b..........@..........b#
#.......................#
#...###...........###...#
#.......................#
#...zzz...........zzz...#
#...###g...w.w...g###...#
#.......................#
#......D.........D......#
#..####...........####..#
#..z##z...........z##z..#
#..####...........####..#
#.......................#
########.........########
########.........########
########.ww.K.ww.########
#########################